Rank2017,Airport,City served,Country,Passengers2017,Passengers2016,Change 2017–2016-Num,Change 2017-2016-%
1,Heathrow Airport,London,United Kingdom,78012825,75711130,2301695,"%3,04"
2,Charles de Gaulle Airport,Paris,France,69471442,65933145,3538297,"%5,37"
3,Amsterdam Airport Schiphol,Amsterdam,Netherlands,68515425,63625664,4889761,"%7,69"
4,Frankfurt am Main Airport,Frankfurt,Germany,64500386,60786937,3713449,"%6,11"
5,Istanbul Atatürk Airport,Istanbul,Turkey,63727448,60415470,3311978,"%5,48"
6,Adolfo Suárez Madrid–Barajas Airport,Madrid,Spain,53402506,50420583,2981923,"%5,91"
7,Barcelona–El Prat Josep Tarradellas Airport,Barcelona,Spain,47284500,44154693,3129807,"%7,09"
8,Gatwick Airport,London,United Kingdom,45556899,43119628,2437271,"%5,65"
9,Munich Airport,Munich,Germany,44577241,42261309,2315932,"%5,48"
10,Leonardo da Vinci–Fiumicino Airport,Rome,Italy,40971881,41744769,-772888,"-%1,85"
11,Sheremetyevo International Airport,Moscow,Russia,39641443,33655605,5985838,"%17,79"
12,Orly Airport,Paris,France,32042475,31237865,804610,"%2,58"
13,Domodedovo International Airport,Moscow,Russia,30657854,28500259,2157595,"%7,57"
14,Dublin Airport,Dublin,Ireland,29582321,27907384,1674937,"%6,00"
15,Zurich Airport,Zürich,Switzerland,29396094,27666428,1729666,"%6,25"
16,Copenhagen Airport,Copenhagen,Denmark,29177833,29043287,134546,"%0,46"
17,Palma de Mallorca Airport,Palma de Mallorca,Spain,27970655,26253882,1716773,"%6,54"
18,Manchester Airport,Manchester,United Kingdom,27773303,25637054,2136249,"%8,33"
19,Oslo Airport,Oslo,Norway,27482486,25787691,1694795,"%6,57"
20,Lisbon Airport,Lisbon,Portugal,26646079,22449289,4196790,"%18,69"
21,Stockholm Arlanda Airport,Stockholm,Sweden,26623606,24682466,1941140,"%7,86"
22,London Stansted Airport,London,United Kingdom,25904450,24320071,1584379,"%6,51"
23,Brussels Airport,Brussels,Belgium,24783911,21818418,2965493,"%13,59"
24,Düsseldorf Airport,Düsseldorf,Germany,24640564,23521919,1118645,"%4,76"
25,Vienna International Airport,Vienna,Austria,24392805,23352016,1040789,"%4,46"
26,Malpensa Airport,Milan,Italy,22169167,19420690,2748477,"%14,15"
27,Athens International Airport,Athens,Greece,21737787,20017530,1720257,"%8,59"
28,Berlin Tegel Airport,Berlin,Germany,20460688,21253959,-793271,"-%3,73"
29,Helsinki Airport,Helsinki,Finland,18892386,17184681,1707705,"%9,94"
30,Málaga Airport,Málaga,Spain,18628876,16672776,1956100,"%11,73"
31,Vnukovo International Airport,Moscow,Russia,18138865,13946688,4192177,"%30,06"
32,Hamburg Airport,Hamburg,Germany,17622997,16224154,1398843,"%8,62"
33,Geneva Airport,Geneva,Switzerland,17351816,16532690,819126,"%4,95"
34,Pulkovo Airport,Saint Petersburg,Russia,16125520,13265037,2860483,"%21,56"
35,Luton Airport,London,United Kingdom,15799219,14551774,1247445,"%8,57"
36,Warsaw Chopin Airport,Warsaw,Poland,15730330,12795356,2934974,"%22,94"
37,Václav Havel Airport Prague,Prague,Czech Republic,15415001,13074517,2340484,"%17,90"
38,Alicante Airport,Alicante,Spain,13713061,12344945,1368116,"%11,08"
39,Edinburgh Airport,Edinburgh,United Kingdom,13410658,12348425,1062233,"%8,60"
40,Nice Côte d'Azur Airport,Nice,France,13304782,12427427,877355,"%7,06"
41,Budapest Ferenc Liszt International Airport,Budapest,Hungary,13097239,11441999,1655240,"%14,47"
42,Birmingham Airport,Birmingham,United Kingdom,12990303,11645334,1344969,"%11,55"
43,Berlin Schönefeld Airport,Berlin,Germany,12865312,11652922,1212390,"%10,40"
44,Henri Coandă International Airport,Bucharest,Romania,12804191,10982967,1821224,"%16,58"
45,Cologne Bonn Airport,Cologne/Bonn,Germany,12384223,11910138,474085,"%3,98"
46,Orio al Serio International Airport,Milan/Bergamo,Italy,12336137,11159631,1176506,"%10,54"
47,Stuttgart Airport,Stuttgart,Germany,10962247,10626430,335817,"%3,16"
48,Porto Airport,Porto,Portugal,10787630,9378082,1409548,"%15,03"
49,Boryspil International Airport,Kyiv,Ukraine,10554757,8650000,1904757,"%22,02"
50,Venice Marco Polo Airport,Venice,Italy,10371380,9624748,746632,"%7,76"
51,Lyon–Saint-Exupéry Airport,Lyon,France,10280192,9553250,726942,"%7,61"
52,Glasgow Airport,Glasgow,United Kingdom,9897959,9346245,551714,"%5,90"
53,Linate Airport,Milan,Italy,9548363,9682264,-133901,"-%1,38"
54,Toulouse–Blagnac Airport,Toulouse,France,9264613,8081179,1183434,"%14,64"
55,Catania-Fontanarossa Airport,Catania,Italy,9120913,7914117,1206796,"%15,25"
56,Marseille Provence Airport,Marseille,France,9002086,8475809,526277,"%6,21"
57,Keflavík International Airport,Reykjavík,Iceland,8755352,6821358,1933994,"%28,35"
58,Faro Airport,Faro,Portugal,8727132,7630909,1096223,"%14,37"
59,Naples Airport,Naples,Italy,8577507,6775988,1801519,"%26,59"
60,Bristol Airport,Bristol,United Kingdom,8239949,7610780,629169,"%8,27"
61,Bologna Guglielmo Marconi Airport,Bologna,Italy,8198156,7680992,517164,"%6,73"
62,Ibiza Airport,Ibiza,Spain,7903892,7416368,487524,"%6,57"
63,EuroAirport Basel Mulhouse Freiburg,Basel/Mulhouse/Freiburg im Breisgau,France  Switzerland,7888725,7314269,574456,"%7,85"
64,Brussels South Charleroi Airport,Charleroi,Belgium,7698767,7303720,395047,"%5,41"
65,Heraklion International Airport,Heraklion,Greece,7336783,6742746,594037,"%8,81"
66,Göteborg Landvetter Airport,Gothenburg,Sweden,6751571,6369396,382175,"%6,00"
67,Valencia Airport,Valencia,Spain,6745394,5799104,946290,"%16,32"
68,Sofia Airport,Sofia,Bulgaria,6490096,4980387,1509709,"%30,31"
69,"Thessaloniki Airport ""Macedonia""",Thessaloniki,Greece,6327174,5687325,639849,"%11,25"
70,Bordeaux – Mérignac Airport,Bordeaux,France,6223414,5779569,443845,"%7,68"
71,"Bergen Airport, Flesland",Bergen,Norway,6113452,5949060,164392,"%2,76"
72,Riga International Airport,Riga,Latvia,6097765,5400243,697522,"%12,92"
73,Malta International Airport,Malta,Malta,6014548,5080071,934477,"%18,39"
74,Ciampino Airport,Rome,Italy,5885812,5395699,490113,"%9,08"
75,Langenhagen Airport,Hanover,Germany,5870104,5408814,461290,"%8,53"
76,Belfast International Airport,Belfast,United Kingdom,5836735,5147546,689189,"%13,39"
77,Kraków John Paul II International Airport,Krakow,Poland,5835189,4983645,851544,"%17,09"
78,Falcone–Borsellino Airport,Palermo,Italy,5775274,5325559,449715,"%8,44"
79,Eindhoven Airport,Eindhoven,Netherlands,5701220,4780197,921023,"%19,27"
80,Nantes Atlantique Airport,Nantes,France,5489087,4778967,710120,"%14,86"
81,Belgrade Nikola Tesla Airport,Belgrade,Serbia,5343420,4924992,418428,"%8,50"
82,Newcastle Airport,Newcastle upon Tyne,United Kingdom,5300274,4807906,492368,"%10,24"
83,Galileo Galilei Airport,Pisa,Italy,5233118,4989496,243622,"%4,88"
84,Rhodes International Airport,Rhodes,Greece,5231159,4942386,288773,"%5,84"
85,Simferopol International Airport,Simferopol,Russia[note 1],5201690,5128743,72947,"%1,42"
86,San Pablo Airport,Seville,Spain,5108807,4624038,484769,"%10,48"
87,Bilbao Airport,Bilbao,Spain,4973712,4588265,385447,"%8,40"
88,Liverpool John Lennon Airport,Liverpool,United Kingdom,4896603,4778939,117664,"%2,46"
89,East Midlands Airport,Derby/Leicester/Nottingham,United Kingdom,4878781,4653818,224963,"%4,83"
90,Bari Airport,Bari,Italy,4686016,4322797,363219,"%8,40"
91,Gdańsk Lech Wałęsa Airport,Gdańsk,Poland,4611714,4004081,607633,"%15,18"
92,London City Airport,London,United Kingdom,4530439,4538813,-8374,"-%0,18"
93,Trondheim Airport Værnes,Trondheim,Norway,4428897,4417490,11407,"%0,26"
94,Nuremberg Airport,Nuremberg,Germany,4186961,3485372,701589,"%20,13"
95,Stavanger Airport Sola,Stavanger,Norway,4178241,4193665,-15424,"-%0,37"
96,Turin Airport,Turin,Italy,4176556,3950908,225648,"%5,71"
97,Cagliari Elmas Airport,Cagliari,Italy,4157612,3695045,462567,"%12,52"
98,Minsk National Airport,Minsk,Belarus,4114512,3429112,685400,"%19,99"
99,Leeds Bradford Airport,Leeds,United Kingdom,4076616,3612117,464499,"%12,86"
100,Katowice Airport,Katowice,Poland,3892941,3221261,671680,"%20,85"
