Rank2019,Airport,City served,Country,Passengers-2019,Passengers-2018,Change 2019-2018-Num,Change 2019-2018-%
1,Heathrow Airport,London,United Kingdom,80886589,80100311,786278,"%0,98"
2,Charles de Gaulle Airport,Paris,France,76150007,72229723,3920284,"%5,43"
3,Amsterdam Airport Schiphol,Amsterdam,Netherlands,71707144,71053157,653987,"%0,92"
4,Frankfurt am Main Airport,Frankfurt,Germany,70556072,69510269,1045803,"%1,50"
5,Adolfo Suárez Madrid–Barajas Airport,Madrid,Spain,61734037,57891340,3842697,"%6,64"
6,Josep Tarradellas Barcelona–El Prat Airport,Barcelona,Spain,52686314,50172457,2513857,"%5,01"
7,Istanbul Airport,Istanbul,Turkey,52009220,95205,51914015,"%54528,66"
8,Sheremetyevo International Airport,Moscow,Russia,49438545,45348150,4090395,"%9,02"
9,Munich Airport,Munich,Germany,47941348,46253620,1687728,"%3,65"
10,Gatwick Airport,London,United Kingdom,46574786,46081327,493459,"%1,07"
11,Leonardo da Vinci–Fiumicino Airport,Rome,Italy,43532573,42995119,537454,"%1,25"
12,Dublin Airport,Dublin,Ireland,32907673,31497526,1410147,"%4,48"
13,Orly Airport,Paris,France,31853049,33120685,-1267636,"-%3,83"
14,Vienna International Airport,Vienna,Austria,31662189,27037292,4624897,"%17,11"
15,Zurich Airport,Zürich,Switzerland,31507692,31113488,394204,"%1,27"
16,Lisbon Airport,Lisbon,Portugal,31173000,29031268,2141732,"%7,38"
17,Copenhagen Airport,Copenhagen,Denmark,30256703,30298531,-41828,"-%0,14"
18,Palma de Mallorca Airport,Palma de Mallorca,Spain,29721123,29081787,639336,"%2,20"
19,Manchester Airport,Manchester,United Kingdom,29367477,28254970,1112507,"%3,94"
20,Malpensa Airport,Milan,Italy,28846299,24725490,4120809,"%16,67"
21,"Oslo Airport, Gardermoen",Oslo,Norway,28592619,28518584,74035,"%0,26"
22,Domodedovo International Airport,Moscow,Russia,28252337,29403704,-1151367,"-%3,92"
23,London Stansted Airport,London,United Kingdom,28124292,27995121,129171,"%0,46"
24,Brussels Airport,Brussels,Belgium,26360003,25675939,684064,"%2,66"
25,Stockholm Arlanda Airport,Stockholm,Sweden,25642703,26845419,-1202716,"-%4,48"
26,Athens International Airport,Athens,Greece,25574030,24135736,1438294,"%5,96"
27,Düsseldorf Airport,Düsseldorf,Germany,25507566,24283967,1223599,"%5,04"
28,Berlin Tegel Airport,Berlin,Germany,24227570,22000430,2227140,"%10,12"
29,Vnukovo International Airport,Moscow,Russia,24001521,21478486,2523035,"%11,75"
30,Helsinki Airport,Helsinki,Finland,21861082,20848838,1012244,"%4,86"
31,Málaga Airport,Málaga,Spain,19856299,19021704,834595,"%4,39"
32,Pulkovo Airport,Saint Petersburg,Russia,19581262,18123064,1458198,"%8,05"
33,Warsaw Chopin Airport,Warsaw,Poland,18869302,17755543,1113759,"%6,27"
34,Luton Airport,London,United Kingdom,18213901,16766552,1447349,"%8,63"
35,Geneva Airport,Geneva,Switzerland,17926629,17677035,249594,"%1,41"
36,Václav Havel Airport Prague,Prague,Czech Republic,17804900,16797006,1007894,"%6,00"
37,Hamburg Airport,Hamburg,Germany,17308773,17234229,74544,"%0,43"
38,Budapest Ferenc Liszt International Airport,Budapest,Hungary,16173399,14867491,1305908,"%8,78"
39,Istanbul Atatürk Airport,Istanbul,Turkey,16112804,68346784,-52233980,"-%76,42"
40,Boryspil International Airport,Kyiv,Ukraine,15260281,12602933,2657348,"%21,09"
41,Alicante Airport,Alicante,Spain,15047840,13981320,1066520,"%7,63"
42,Edinburgh Airport,Edinburgh,United Kingdom,14733966,14291811,442155,"%3,09"
43,Henri Coandă International Airport,Bucharest,Romania,14707376,13820428,886948,"%6,42"
44,Nice Côte d'Azur Airport,Nice,France,14485423,13850561,634862,"%4,58"
45,Orio al Serio International Airport,Milan/Bergamo,Italy,13857257,12938572,918685,"%7,10"
46,Porto Airport,Porto,Portugal,13107000,11939562,1167438,"%9,78"
47,Stuttgart Airport,Stuttgart,Germany,12721441,11798090,923351,"%7,83"
48,Birmingham Airport,Birmingham,United Kingdom,12646456,12454642,191814,"%1,54"
49,Cologne Bonn Airport,Cologne/Bonn,Germany,12368519,12957828,-589309,"-%4,55"
50,Lyon–Saint-Exupéry Airport,Lyon,France,11739600,11037410,702190,"%6,36"
51,Venice Marco Polo Airport,Venice,Italy,11561594,11184608,376986,"%3,37"
52,Berlin Schönefeld Airport,Berlin,Germany,11417435,12725937,-1308502,"-%10,28"
53,Naples Airport,Naples,Italy,10860068,9932029,928039,"%9,34"
54,Catania-Fontanarossa Airport,Catania,Italy,10223113,9933318,289795,"%2,92"
55,Marseille Provence Airport,Marseille,France,10151743,9390371,761372,"%8,11"
56,Toulouse–Blagnac Airport,Toulouse,France,9620224,9630308,-10084,"-%0,10"
57,Bologna Guglielmo Marconi Airport,Bologna,Italy,9405920,8506658,899262,"%10,57"
58,EuroAirport Basel Mulhouse Freiburg,Basel/Mulhouse/Freiburg im Breisgau,France  Switzerland,9094821,8573705,521116,"%6,08"
59,Faro Airport,Faro,Portugal,9009000,8685571,323429,"%3,72"
60,Bristol Airport,Bristol,United Kingdom,8959679,8696653,263026,"%3,02"
61,Glasgow Airport,Glasgow,United Kingdom,8843214,9652216,-809002,"-%8,38"
62,Valencia Airport,Valencia,Spain,8539403,7769867,769536,"%9,90"
63,Kraków John Paul II International Airport,Kraków,Poland,8410817,6769369,1641448,"%24,25"
64,Brussels South Charleroi Airport,Charleroi,Belgium,8224450,8029680,194770,"%2,43"
65,Ibiza Airport,Ibiza,Spain,8155635,8104316,51319,"%0,63"
66,Heraklion International Airport,Heraklion,Greece,7839255,7974887,-135632,"-%1,70"
67,Riga International Airport,Riga,Latvia,7798382,7056099,742283,"%10,52"
68,Bordeaux–Mérignac Airport,Bordeaux,France,7703135,6799572,903563,"%13,29"
69,Seville Airport,Seville,Spain,7544473,6380465,1164008,"%18,24"
70,Malta International Airport,Malta,Malta,7310289,6808177,502112,"%7,38"
71,Keflavík International Airport,Reykjavík,Iceland,7247820,9804388,-2556568,"-%26,08"
72,Nantes Atlantique Airport,Nantes,France,7227411,6199181,1028230,"%16,59"
73,Sofia Airport,Sofia,Bulgaria,7107096,6962040,145056,"%2,08"
74,Falcone–Borsellino Airport,Palermo,Italy,7018087,6628558,389529,"%5,88"
75,Thessaloniki Airport Macedonia,Thessaloniki,Greece,6897057,6689193,207864,"%3,11"
76,Eindhoven Airport,Eindhoven,Netherlands,6780796,6237755,543041,"%8,71"
77,Göteborg Landvetter Airport,Gothenburg,Sweden,6671361,6807976,-136615,"-%2,01"
78,Linate Airport,Milan,Italy,6570984,9233475,-2662491,"-%28,84"
79,"Bergen Airport, Flesland",Bergen,Norway,6505827,6306623,199204,"%3,16"
80,Langenhagen Airport,Hanover,Germany,6301366,6324634,-23268,"-%0,37"
81,Belfast International Airport,Belfast,United Kingdom,6278374,6268953,9421,"%0,15"
82,Belgrade Nikola Tesla Airport,Belgrade,Serbia,6159000,5641105,517895,"%9,18"
83,Bilbao Airport,Bilbao,Spain,5905804,5469453,436351,"%7,98"
84,Ciampino Airport,Rome,Italy,5879496,5839737,39759,"%0,68"
85,Bari Airport,Bari,Italy,5545588,5030760,514828,"%10,23"
86,Rhodes International Airport,Rhodes,Greece,5542567,5567748,-25181,"-%0,45"
87,Galileo Galilei Airport,Pisa,Italy,5387558,5463090,-75532,"-%1,38"
88,Gdańsk Lech Wałęsa Airport,Gdańsk,Poland,5376120,4980647,395473,"%7,94"
89,Newcastle Airport,Newcastle upon Tyne,United Kingdom,5198952,5332238,-133286,"-%2,50"
90,Simferopol International Airport,Simferopol,Russia,5140000,5146095,-6095,"-%0,12"
91,London City Airport,London,United Kingdom,5122039,4820292,301747,"%6,26"
92,Minsk National Airport,Minsk,Belarus,5101766,4536618,565148,"%12,46"
93,Vilnius Airport,Vilnius,Lithuania,5004921,4922949,81972,"%1,67"
94,Liverpool John Lennon Airport,Liverpool,United Kingdom,5000176,5042312,-42136,"-%0,84"
95,Katowice Airport,Katowice,Poland,4843889,4838149,5740,"%0,12"
96,Cagliari Elmas Airport,Cagliari,Italy,4747806,4370014,377792,"%8,65"
97,East Midlands Airport,Derby/Leicester/Nottingham,United Kingdom,4674338,4873757,-199419,"-%4,09"
98,Krasnodar International Airport,Krasnodar,Russia,4630770,4160053,470717,"%11,32"
99,Luxembourg Airport,Luxembourg City,Luxembourg,4416038,4036878,379160,"%9,39"
100,Trondheim Airport Værnes,Trondheim,Norway,4381921,4441791,-59870,"-%1,35"
